  ////////////////////////////////////////////////////////////////////////////////////////////////////////////////////////////////////////////////////////////////////////////////////////////////////* 
  @@@@@@@@@@@@@@@@@@@@@@@@@@@@@@@@@@@@@@@@@@@@@@@@@@@@@@@@@@@@@@@@@@@@@@@@@@@@@@@@@@@@@@@@@@@@@@@@@@@@@@@@@@@@@@@@@@@@@@@@@@@@@@@@@@@@@@@@@@@@@@@@@@@@@@@@@@@@@@@@@@@@@@@@@@@@@@@@@@@@@@@@@@@@@@@@@@@@& 
  %                                                                                                                                                                         ....................      & 
  %                                                                                                                                                                        .     **.%% *              & 
  %                                                                                                                                                                        .                          & 
  %                                                                                                                                                                        .            .             & 
  %                                                                                                                                                                        . /... ....**,,**,**       & 
  %                                                @#                                                                                                                      .      #,* . ..            & 
  %                                       ,##.&         %&&                                                                                                                .                          & 
  %                                     %                   #                                                                                                                                         & 
  %                                   (                    .*                                                                                                                                         & 
  #                                     , .                    ./          */     *,                                                                                                                  & 
  %                                          .*                      &%*%            (&&                                                                                                              & 
  %                                           .#                                       .                                                                                                              & 
  %                                           &,         (10)                         /                                                                                                               & 
  %                                        .          [Srinagar]                  .(                                                                                                                  & 
  %                                         (                                     (                                                                                                                   & 
  %                                         .                                 ..                                                                                                                      & 
  %                                          (                                /                                                                                                                       & 
  %                                          (                                  *&                                                                                                                    & 
  %                                             *(.&                             /                                                                                                                    & 
  %                                                .(/#                    & %  @/                                                                                                                    & 
  %                                                    //       [Shimla]   ./                                                                                                                         & 
  %                                                &              (11)       %                                                                                                                        & 
  %                                                %       (12)              @                                                                                                                        & 
  %                                               /,    Chandigah               .,                                                                                                                    & 
  %                                              %                     (21)          @/                                                                                                               & 
  %                                            &                     Dehra Dun         /&#                                                                                                            & 
  %                                           ,*                                          #,                                                                                                          & 
  %                                        @                                           .&                                                                                                             & 
  %                                       (                                            /                                                                                                  &           & 
  %                                      #                       [New Delhi]          @                                                                                       ,*   ./*     /&         & 
  %                                  @                             (2)                #.                                                                                    @                (        & 
  %                                 &                                                      &/                                                                           &                   ##&,/     & 
  %                      (        #                                                           ,%                                          /(&                        #                            &   & 
  %                   ,.   %%                                                                       &%@                                 @    ,                #&(            Itanagar           &     & 
  %                 .%                                                                                   ,&  ,  #&(                    .     #                   @             (24)          *& %     & 
  %                &                                      (3)                                                      &(       (    /-(*)      /    &                   @                      /#        & 
  %                 &/*                                [Jaipur]                     (9)                               %(&(&(&***                                         .%*               &          & 
  %                    &                                                         [Lucknow]                                                @ (#%             Dispur                  @ /]/             & 
  %                    *                                                                                         Patna                  &        / #         (19)                   /                 & 
  %                       @                                                                                       (16)                    *%       #                              .*                  & 
  %                        &                                                                (25)                                          ,&&&      (&, . /(%   .                #                    & 
  &.                        &                                                             Prayagraj                                     %%                        %&             ,                    & 
  %   ,                     (                                                                                                           (#                       *              &                     & 
  %    .      #     ,%/                                                                                                                     (                *#&/        .     (                      & 
  %       .&(##                                                                                                                            #               ..     .      ,    .                       & 
  %          &               (18)                                     (13)                                     Ranchi                       &          .    #   &        (                            & 
  %           ,#   %@@   [Gandhinagar]                               Bhopal                                     (17)                         #              ,,*&   .    @&                            & 
  %                     ,                                                                                                           [Kolkata]#         *  .  *      .  .                              & 
  %            ../@(.                %*.                                                                                               (1)    *         *, .   *    &   &                             & 
  %              @                  & &&                                                                                               .&     &    *, *,        *   . (                               & 
  %                ,/               #  %                                                                                          ,%&.   ( (#                                                         & 
  %                   %            @   %                                                                                        @                                .                                    & 
  %                      @   .&*        /                                  [Nagpur]              (14)                            *                                ,                                   & 
  %                                     &                                    (8)               [Raipur]            Bhubaneshwar/                                                                      & 
  %                                    &                                                                                 (15)./                                       ,  ,                            & 
  %                                    &                                                                              @%@(_./                                              .                          & 
  %                                    .@ [Mumbai]                                                                  ,%                                                    *..                         & 
  %                                     && (5)                                                                    *.                                                        */                        & 
  %                                     (                                                                       *.                                                                                    & 
  %                                      *                                                                   ,%                                                                                       & 
  %                                                                                                       /.                                                                    ,                     & 
  %                                       #                                                            /(                                                                                             & 
  %                                       (                            [Hyderabad]                     #                                                                        ,                .    & 
  %                                        &                               (4)                        /                                                                                           .   & 
  %                                        .                                                 @(...                                                                                       .*.        / & 
  %                                         &                                                (7)  @ [Vijayawada]                                                                ,.  (               . &
  %                                            /                                     .                                                                                                               ,& 
  %                                             @                                                                                                                                                    %& 
  %                                               . Panaji                                   &                                                                                                        & 
  %                                               # (22)                                  %                                                                                                           & 
  %                                                ,                                    @                                                                                                             & 
  %                                                 (                                  &                                                                              &(                              & 
  %                                                 ,        Bengaluru              (6)   [Chennai]                                                                  .&                               & 
  %                                                  ,          (20)                  &                                                                              &(,                              & 
  %                                                   .*                            (                                                                               .@,                               & 
  %                                                     ./                         *                                                                                ,@                                & 
  %                                                       &                         (                                                                                                                 & 
  %                                 %                      &                        /                                                                                                                 & 
  %                                   *,                    @                       @                                                                              @(                                 & 
  %                                 .        *               @                  %                                                                                                                     & 
  %                                                           @                &     ..                                                                                                               & 
  %                                                     [Thiruvananthapuram] _*.      *                                                                                                               & 
  %                                                            #((23)     %//       /      .                                                                                                          & 
  %                                                              %       #          .       /                                                                                                         & 
  #                                      .                         %, /&                                                                                               ,* @                           & 
  %                                                                                            *                                                                                                      & 
  %                                                                                 .           /                                                                          %                          & 
  %                                       .                                         /                                                                                      %.                         & 
  %                                     ,(                                                      *                                                                                                     & 
  %                                   @                                                       ,                                                                                                       & 
  &///////////////////////////////////////////////////////////////////////////////////////////////////////////////////////////////////////////////////////////////////////////////////////////////////& 